                1111
               11  11           1111111111  11          11  11       11
              11    11          11          11          11  11     11
             11      11         11          11          11  11   11
            11     b  11        111111      11          11  11 11
           11          11       11          11          11  1111 11
          11            11      11          11          11  11    11
         11       s      11     11           111      111   11     111
        11        s       11    11             1111111      11       111
       11              m   11
      11111111111  11111111111
               11  11
              11    11
              11    11
              11    11
              11    11
              11    11
          111111    111111
        11    11    11    1111
        11    11    11    11  11
111111  11    11    11    11    11
11    1111                11    11
11      11                      11
  11    11                      11
   111  11                      11
    11                          11
     111                        11
      11                      111
       111                    11
        11                    11
         111                111
          11                11
          111111111  111111111