111111111
1       1
1   s   1
1   s   1
1    b  1
1       1
1       1
1  m    1
111111111